###############
#.............#
#.#####.#####.#
#...#.....#...#
#.#...###...#.#
#.#.#.#^#.#.#.#
#.#.#.# #.#.#.#
#...#.....#...#
#......#......#
####.#.#.#.####
#....#.#.#....#
#.##...p...##.#
#.##.#####.##.#
#.............#
###############
