

 111     11    11        1
         11   1  1      1 1
               1 1       1 1
                1         1






       11111







     111
       1
      1

     1
      1
  1   1
   1111


